
NO ./textures/trgaspar.png
SO ./textures/mlapique.png
WE ./textures/dave.png
EA ./textures/tonton.png
C 88,200,200
F 150,120,88


   11   11111111111111111111111111111111111111111111111111111111111111111111111111111111111111111111111111111111111111111111111
  1  1  111000011100000000000000000000000000000000000000000000000000000000000000000000000000000000000000000000000000000000000011
  1  1  100000000011000000000000000000000000000000000000000000000000000000000000000000000000000000000000000000000000000000000001
   11   101100000111000000000000000000000000000000000000000000DD0000000000000000000000000000000000000000000000000000000000000001
        100100000O00000000000000000000000000000000000000000000000000000000000000000000000000000000000000000000000000000000000001
11111111101100000111000000000000000000000000000000000000000000000000000000000000000000000000000000000000000000000000000000000001
10000000001100000111011111D11111111111111111111111111111111111111111111111111111111111111111111111111111111111111111111111111111
11110111111110011100000010001
11110111111111O11101010010001
11000000110101011100000010001
10000000000000001100000010001
100000000000000011010100100011
11000001110101011111011110N0111
11110111 1110101 101111010001
11111111  111111 111111111111


        1111111111111111111111111
   1    1000000000110000000000001
  11    1011000001110000000000001
   1    1001000000000000000011111
   1    100100000000000000001
        111111111111111111111



        1111111111111111111111111
        1000000000110000000000001
        1011000001110000000000001
        1001000000000000000011111
        100100000000000000001
        111111111111111111111



        1111111111111111111111111
        1000000000110000000000001
        1011000001110000000000001
        1001000000000000000011111
        100100000000000000001
        111111111111111111111



        1111111111111111111111111
        1000000000110000000000001
        1011000001110000000000001
        1001000000000000000011111
        100100000000000000001
        111111111111111111111



        1111111111111111111111111
        1000000000110000000000001
        1011000001110000000000001
        1001000000000000000011111
        100100000000000000001
        111111111111111111111



        1111111111111111111111111
        1000000000110000000000001
        1011000001110000000000001
        1001000000000000000011111
        100100000000000000001
        111111111111111111111



        1111111111111111111111111
        1000000000110000000000001
        1011000001110000000000001
        1001000000000000000011111
        100100000000000000001
        111111111111111111111



        1111111111111111111111111
        1000000000110000000000001
        1011000001110000000000001
        1001000000000000000011111
        100100000000000000001
        111111111111111111111



        1111111111111111111111111
        1000000000110000000000001
        1011000001110000000000001
        1001000000000000000011111
        100100000000000000001
        111111111111111111111



        1111111111111111111111111
        1000000000110000000000001
        1011000001110000000000001
        1001000000000000000011111
        100100000000000000001
        111111111111111111111



        1111111111111111111111111
        1000000000110000000000001
        1011000001110000000000001
        1001000000000000000011111
        100100000000000000001
        111111111111111111111

