
NO ./textures/mlapique.jpeg
SO ./textures/trgaspar.jpg
WE ./textures/dave.jpeg
EA ./textures/hug.jpeg
F 220,100,0
C 225,30,0


        1111111111111111111111111
        1000000000110000000000001
        1011000001110000000000001
        100100000D000000000000001
111111111011000001110000000000001
10000000001100000111011111D111111
11110111111110011100000010001
11110111111111011101010010001
11000000110101011100000010001
10000000000000001100000010001
100000000000000011010100100011
1100000111010101111101111N00111
11110111 1110101 101111010001
11111111 1111111 111111111111


        1111111111111111111111111
        1000000000110000000000001
        1011000001110000000000001
        1001000000000000000011111
        100100000000000000001
        111111111111111111111
