
NO ./textures/cmetg_lunettes.png
SO ./textures/dave.png
C 88,200,200
WE ./textures/illbeokay.png
EA ./textures/tonton.png
F 10,10,2147483648


   11   111111111111111111111111111111111111111111111111111111111111111
  10S1  111000011100000000000000000000000000000000000000000000000000011
  1001  1000000000110000000000000000000000000000000000000000000000000001
   11   1011000001110000000000000000000000000000000000000000000000000001
        100100000O000000000000000000000000000000000000000000000000000001
111111111011000001110000000000000000000000000000000000000000000000000001
10000000001100000111011111D111111111111111111111111111111111111111111111
11110111111110011100000010001
11110111111111O11101010010001  1
11000000110101011100000010001 111
10000000000000001100000010001  1
100000000000000011010100100011
1100000111010101111101111000111
11110111 1110101 101111010001
11111111  111101 111111111111
             101
             101
        111111011111111111111111111111111111111111111111111111111111111111111111111
   1    100000000011000000000000110000000001100000000000011000000000110000000000001
  11    101100000111000000000000110110000011100000000000011011000001110000000000001
   1    100100000000000000001111110010000000000000000111111001000000000000000011111
   1    100100000000000000001    100100000000000000001    100100000000000000001    
        111111111111111111111    111111111111111111111    111111111111111111111    
                    111
                    101
                    101
                    101
        111111111111101111111111111111111111111111111111111111111111111111111111111
   1    100000000011000000000000110000000001100000000000011000000000110000000000001
  11    101100000111000000000000110110000011100000000000011011000001110000000000001
   1    100100000000000000001111110010000000000000000111111001000000000000000011111
   1    100100000000000000001    100100000000000000001    100100000000000000001    
        111111011111111111111    111111111111111111111    111111111111111111111    
        111111011111111111111111111111111111111111111111111111111111111111111111111
   1    100000000011000000000000110000000001100000000000011000000000110000000000001
  11    101100000111000000000000110110000011100000000000011011000001110000000000001
   1    100100000000000000001111110010000000000000000111111001000000000000000011111
   1    100100000000000000001    100100000000000000001    100100000000000000001    
        111111111111101111111    111111111111111111111    111111111111111111111    
                    101
                    101
                    101
                    101
        111111111111101111111111111111111111111111111111111111111111111111111111111
   1    100000000011000000000000110000000001100000000000011000000000110000000000001
  11    101100000111000000000000110110000011100000000000011011000001110000000000001
   1    100100000000000000001111110010000000000000000111111001000000000000000011111
   1    100100000000000000001    100100000000000000001    100100000000000000001    
        111111011111111111111    111111111111111111111    111111111111111111111    
        111111011111111111111111111111111111111111111111111111111111111111111111111
   1    100000000011000000000000110000000001100000000000011000000000110000000000001
  11    101100000111000000000000110110000011100000000000011011000001110000000000001
   1    100100000000000000001111110010000000000000000111111001000000000000000011111
   1    100100000000000000001    100100000000000000001    100100000000000010001    
1111111111111111111111111111111111111111D111111111111111111111111111111111111111111
