NO ./textures/cmetg_lunettes.png
SO ./textures/cmetg_lunettes.png
WE ./textures/cmetg_lunettes.png
EA ./textures/cmetg_lunettes.png
C b,b,c
F p,8,255

   11   11111111111111111111111111111111111111111
  1  1  1110000111000000000000000000000000000000011
  1  1  1000000000110000000000000000000000000000001
   11   1011000001110000000000000000000000000000001
        100100000O000000000000000000000000000000001
111111111011000001110000000000000000000000000000001
10000000001100000111011101D111111111111111111111111
11110111111110011100000010001        
11110111111111O11101010010001        
11000000110101011100000010001    11  
10000000000000001100000010001   1  1 
100000000000000011010100100001    1  
11000001110101011111011100N0111  1   
11110111 1110101 101111010001   1111 
11111111  111111 111111111101         
                           1

        1111111111111111111111111
   1    1000000000110000000000001
  11    1011000001110000000000001
   1    100100000000000000011111
   1    100100000000000000001
        111111111111111111111

