C 88,200,200
NO ./textures/cmetg_lunettes.png
SO ./textures/dave.png
WE ./textures/illbeokay.png
EA ./textures/tonton.png


F 111,111,111

11111111111111111111111111111111111111111
11NDDDDDDDDDDDDDDDDDDDDDDDDDDDDDDDDDD1111
11DDDDDDDDDDDDDDDDDDDDDDDDDDDDDDDDDDD1111
11DDDDDDDDDDDDDDDDDDDDDDDDDDDDDDDDDDD1111
11DDDDDDDDDDDDDDDDDDDDDDDDDDDDDDDDDDD1111
11DDDDDDDDDDDDDDDDDDDDDDDDDDDDDDDDDDD1111
11DDDDDDDDDDDDDDDDDDDDDDDDDDDDDDDDDDD1111
11DDDDDDDDDDDDDDDDDDDDDDDDDDDDDDDDDDD1111
11DDDDDDDDDDDDDDDDDDDDDDDDDDDDDDDDDDD1111
11DDDDDDDDDDDDDDDDDDDDDDDDDDDDDDDDDDD1111
11DDDDDDDDDDDDDDDDDDDDDDDDDDDDDDDDDDD1111
11DDDDDDDDDDDDDDDDDDDDDDDDDDDDDDDDDDD1111
11DDDDDDDDDDDDDDDDDDDDDDDDDDDDDDDDDDD1111
11DDDDDDDDDDDDDDDDDDDDDDDDDDDDDDDDDDD1111
11DDDDDDDDDDDDDDDDDDDDDDDDDDDDDDDDDDD1111
11DDDDDDDDDDDDDDDDDDDDDDDDDDDDDDDDDDD1111
11DDDDDDDDDDDDDDDDDDDDDDDDDDDDDDDDDDD1111
11DDDDDDDDDDDDDDDDDDDDDDDDDDDDDDDDDDD1111
11DDDDDDDDDDDDDDDDDDDDDDDDDDDDDDDDDDD1111
11DDDDDDDDDDDDDDDDDDDDDDDDDDDDDDDDDDD1111
11DDDDDDDDDDDDDDDDDDDDDDDDDDDDDDDDDDD1111
11DDDDDDDDDDDDDDDDDDDDDDDDDDDDDDDDDDD1111
11DDDDDDDDDDDDDDDDDDDDDDDDDDDDDDDDDDD1111
11DDDDDDDDDDDDDDDDDDDDDDDDDDDDDDDDDDD1111
11DDDDDDDDDDDDDDDDDDDDDDDDDDDDDDDDDDD1111
11DDDDDDDDDDDDDDDDDDDDDDDDDDDDDDDDDDD1111
11DDDDDDDDDDDDDDDDDDDDDDDDDDDDDDDDDDD1111
11DDDDDDDDDDDDDDDDDDDDDDDDDDDDDDDDDDD1111
11111111111111111111111111111111111111111
